Inger	Kluck	New York
Marybelle	Gravelle	London
Judi	Dahlin	Tokyo
Kraig	Burtenshaw	Madrid
Ted	Hadaway	Nairobi
Erminia	Pippenger	Los Angeles
Albert	Misiewicz	Lima
Garland	Palau	Rio de Janeiro
Gregg	Fiske	Mumbai
Arvilla	Dorantes	Sao Paulo
Caleb	Mathieu	Jakarta
Lupita	Philbeck	Dehli
Hank	Edmiston	Singapore
Edith	Windley	Madrid
Valentina	Hiles	Bangkok
Harland	Almon	Busan
Portia	Yarbro	Casablanca
Hugo	Wurm	Nairobi
Peg	Mccormick	London
Erica	Waldon	Tianjin
